# # # # # # # # # # # # #
#                      #
# # # #                 #
#     # # # #           #
#     #           #     #
#     #           #
#                       #
# # # # # # # # # # # # #