# # # # # # # # # # # # #
1 .   .     *      #    #
# # # #                 #
#     # # # #           #
#     #           #     #
#     #           #
#                       #
# # # # # # # # # # # # #