# # # # # # # # # # # # #
1                  #    #
# # # #                 #
#     # # # #           #
#     #           #     #
#     #           #
#                       #
# # # # # # # # # # # # #