# # # # # # # # # # # # #
1 .   .   * * *   #     #
# # # #           .     #
#     # # # #           #
#     #           #     #
#     #           #
#                 D     #
# # # # # # # # # # # # #