# # # # # # # # # # # # #
1 .   .   *   *   #     #
#   # #           .     #
#   * # # # #           #
#  .        .           #
# # # # # # # # # # # # #