# # # # # # # # # # # # #
1 .   .   *   *   #     #
#   # #           # # D #
#   * # # # #           #
#  .        .           #
# # # # # # # # # # # # #